1111111111111111111111111111111111111111
1000000000000000000000000000000000000001
1000000001010000000000000000001000000001
100000000000000000000E000000000000000001
1000000000000000000000000000001111100001
1000000000000000000000000000001111100001
1111111111111111111111111111111111111111
