F 76,76,76
C 3,22,44

NO texture/wall_N.xpm
SO texture/wall_S.xpm
WE texture/wall_W.xpm
EA texture/wall_E.xpm



1111111111111111111111111111111111111111
10000000010C0000000000000000D000C0000001
1000000001d10000000000000000111000000001
1000000000000000000000000000000000000001
1000000000000000000000000000000000000001
1000000000000000000000000000000000000001
1000000000000000000000000000000000000001
1000000000N00000000000000000000000000001
1000000000000000000000000000000000000001
1000000000000000000000000000000000000001
1000000000000000000000000000000000000001
1000000000000000000000000000000000000001
1000000000000000000000000000000000000001
1000000000000000000000000000000000000001
1000000000000000000000000000000000000001
1000000000000000000000000000000000000001
1000000000000000000000000000000000000001
1000000000000000000000000000001111100001
1111111111111111111111111111111111111111
