1111111111111111111111111111111111111111
1S00000000100000000000000000000000000001
1000000000100000000000000000000000000001
1000000000000000000000000000000000000001
1000000000100000000000000000001111100001
1111111111111111111111111111111111111111
