1111111111111111111111111                                            
1000011100110000000000001                                            
1011000001110000000000001                                            
100111000000000000000000111111111                                    
111111111011000001110000E00000001                                    
100000000011000001110111111111111                                    
11110111111111011100000010001                                        
11110111111111011101010010001                                        
11000000110101011100000010001                                        
10000000000000001100000010001                                        
10000000000000001101010010001                                        
1100000111010101111101111000111                                      
11110111 1110101 101111010001                                        
11000001110101011100000010001                                        
10000000000000001100000010001                                        
10000000000000001101010010001                                        
11110100000000000000000010001                                        
110000001101010111000000100011111111111111111111111111111111111111111
100000000000000011000000000000000000000000000000000000000000000000001
100000000000000011010100000000000000000000000000000000000000000000001
111101111111110111010100100011111111111111111111111111111111111111111
11000000110101011100000010001                                        
10000000000000001100000010001                                        
10000000000000001101010010001                                        
11111111011111110111111111111                                        
       111     111                                                   
