F 76,76,76
C 3,22,44

NO texture/wall_N.xpm
SO texture/wall_S.xpm
WE texture/wall_W.xpm
EA texture/wall_E.xpm

1111111111111111111111111111111111                                            
1000000000000000000000000000000001                                            
1011000000000000000000000111110001                                            
1011110000000000000000001111111111                                    
101111111011000001110000000N000011                                    
1000000000110000011101111111111111                                    
11110111111111011100000010001                                        
11110111111111011101010010001                                        
11000000110101011100000010001                                        
10000000000000001100000010001                                        
10000000000000001101010010001                                        
1100000111010101111101111000111                                      
11110111 1110101 101111010001                                        
11000001110101011100000010001                                        
10000000000000001100000010001                                        
10000000000000001101010010001                                        
11110100000000000000000010001                                        
110000001101010111000000100011111111111111111111111111111111111111111
100000000000000011000000000000000000000000000000000000000000000000001
100000000000000011010100000000000000000000000000000000000000000000001
111101111111110111010100100011111111111111111111111111111111111111111
11000000110101011100000010001                                        
10000000000000001100000010001                                        
10000000000000001101010010001                                        
11111111011111110111111111111                                        
       111     111                                                   
