1111111111111111111111111111111111111111
1000000E00000000000000000000000000000001
1111111111111111111111111111111111111111
